LAYOUT 1 7 100
01 -1  0
02 -1  1
03  0 -1
04  0  0
05  0  1
06  1  0
07  1  1

LAYOUT 2 9 110
01 -1  0
02 -1  1
03 -1  2
04  0 -1
05  0  0
06  0  1
07  1 -1
08  1  0
09  1  1

LAYOUT 3 11 120
01 -2  1
02 -1  0
03 -1  1
04 -1  2
05  0 -1
06  0  0
07  0  1
08  1 -1
09  1  0
10  1  1
11  2 -1

LAYOUT 4 14 140
01 -2 -1
02 -2  0
03 -1 -1
04 -1  0
05 -1  1
06  0 -2
07  0 -1
08  0  0
09  0  1
10  1 -1
11  1  0
12  1  1
13  2 -1
14  2  0

LAYOUT 5 16 150
01 -1 -2
02 -1 -1
03 -1  0
04 -1  1
05 -1  2
06  0 -3
07  0 -2
08  0 -1
09  0  0
10  0  1
11  0  2
12  1 -2
13  1 -1
14  1  0
15  1  1
16  1  2

LAYOUT 6 17 160
01 -3  0
02 -3  1
03 -2 -1
04 -2  0
05 -2  1
06 -1  0
07 -1  1
08  0 -1
09  0  0
10  0  1
11  1  0
12  1  1
13  2 -1
14  2  0
15  2  1
16  3  0
17  3  1

LAYOUT 7 19 180
01 -2 -1
02 -2  0
03 -2  1
04 -1 -1
05 -1  0
06 -1  1
07 -1  2
08  0 -2
09  0 -1
10  0  0
11  0  1
12  0  2
13  1 -1
14  1  0
15  1  1
16  1  2
17  2 -1
18  2  0
19  2  1

LAYOUT 8 22 200
01 -3 -1
02 -3  0
03 -3  1
04 -2 -2
05 -2 -1
06 -2  0
07 -2  1
08 -1 -1
09 -1  0
10 -1  1
11 -1  2
12  0 -1
13  0  0
14  0  1
15  0  2
16  1  0
17  1  1
18  1  2
19  1  3
20  2  0
21  2  1
22  2  2

